41 41
0 0 40 40
o o x x x x x x x x x x x x x x x x x x x x x x x x x x x x x x x x x x x x x x x
o o o o x o x o x o o o x o x o o o x o o o o o o o x o o o o o x o o o o o o o x
x x x o x o x o x o x x x o x o x x x o x x x o x o x x x o x x x x x o x x x o x
x o o o o o o o o o o o o o o o o o o o x o o o x o x o o o o o x o o o o o x o x
x o x x x o x x x x x o x o x x x o x x x x x x x x x x x o x x x x x o x x x o x
x o x o x o x o o o x o x o o o x o x o x o o o x o o o o o o o o o o o x o o o x
x o x o x o x o x o x o x o x x x x x o x o x x x o x x x o x o x x x o x o x o x
x o o o x o o o x o x o x o o o o o x o o o o o x o x o o o x o o o x o x o x o x
x o x x x o x x x x x x x x x x x o x x x x x o x x x x x o x x x x x x x o x x x
x o o o x o o o x o o o o o o o o o o o o o o o o o o o o o x o x o x o o o o o x
x x x x x x x o x o x o x o x x x o x o x x x o x o x o x x x o x o x o x x x o x
x o x o x o o o x o x o x o x o o o x o x o x o x o x o x o x o x o o o o o x o x
x o x o x o x x x x x x x o x x x x x o x o x o x x x o x o x o x o x o x x x x x
x o o o o o x o x o o o x o x o o o x o x o o o x o x o x o x o o o x o x o o o x
x o x x x x x o x o x o x o x o x x x o x x x x x o x o x o x o x x x o x o x o x
x o o o x o o o o o x o x o o o x o o o o o x o o o x o o o x o x o o o x o x o x
x o x x x x x x x o x x x x x x x o x x x x x o x x x x x o x x x x x x x x x o x
x o x o o o o o o o o o x o x o x o o o x o o o o o o o o o o o o o x o o o o o x
x o x x x o x x x x x x x o x o x x x o x o x x x o x x x x x o x o x o x x x x x
x o o o x o o o o o o o x o o o o o o o x o x o o o o o o o x o x o o o x o o o x
x x x o x x x x x o x x x x x x x o x o x x x x x o x o x x x o x x x o x o x x x
x o o o o o o o x o o o x o x o o o x o x o o o o o x o o o x o x o x o o o x o x
x o x o x o x x x o x o x o x o x o x o x o x x x x x x x x x o x o x x x x x o x
x o x o x o o o x o x o o o o o x o x o x o o o x o o o x o x o o o x o x o o o x
x o x x x o x x x o x o x o x o x x x x x x x x x x x o x o x x x o x o x x x o x
x o o o x o x o x o x o x o x o x o o o x o o o o o o o o o o o o o o o x o x o x
x x x o x x x o x x x o x o x x x x x o x x x o x o x o x x x x x x x x x o x o x
x o x o o o o o x o o o x o o o o o x o o o o o x o x o o o o o x o x o o o o o x
x o x o x o x x x x x x x o x x x o x x x x x o x x x x x x x o x o x x x o x x x
x o o o x o o o o o x o o o o o x o x o x o o o x o o o o o o o x o x o o o x o x
x x x x x o x x x x x x x x x x x o x o x o x x x x x o x x x o x o x o x o x o x
x o o o x o o o x o o o x o x o o o x o o o o o x o x o x o x o o o o o x o o o x
x o x o x x x o x o x x x o x x x x x o x x x x x o x o x o x o x o x o x x x x x
x o x o x o x o x o x o o o o o x o o o o o x o o o o o x o o o x o x o o o x o x
x o x x x o x x x o x o x o x o x o x o x o x x x x x x x o x x x o x x x o x o x
x o o o o o o o o o o o x o x o o o x o x o x o o o x o x o x o x o o o x o o o x
x o x x x x x o x o x x x x x o x x x o x o x x x o x o x x x o x x x x x o x x x
x o x o x o x o x o x o o o o o x o o o x o o o o o x o o o o o o o o o x o x o x
x o x o x o x x x o x x x x x o x o x x x o x o x o x x x x x x x o x o x x x o x
x o o o o o o o x o x o o o o o x o x o o o x o x o o o o o o o o o x o o o o o x
x x x x x x x x x x x x x x x x x x x x x x x x x x x x x x x x x x x x x x x o o